#########################################
S....#....#.#.#....#....................E
###.#.#####.#.#.###.#.#.#.#.###.#.#.#####
#...#.#...#.#.#...#.#.#.#.#.#.#...#......
#.#####.#.###.###.#####..####.#.#.###.#.#
#.....#.#......#...#.#.#.....#.#.........
#.###.#.#######.###.########.##.#######.#
#.#.#.#.#.#...#..........#.#.#...........
###.#.#.#.###.#######.#.####.######.#.#.#
#.#.#.#.#.#.#.#.#...#.#.#..#.............
#.#.#.#.#.#.###.#.#.#####.###.#.#######.#
#.#.....................................#
#########################################