#########################################
S....#....#.#.#....#.....................
###.#.#####.#.#.###.#.###.#.###.#.#.#####
#...#.#...#.#.#...#.#.#.#.#.#.#...#......
#.#####.#.###.###.#####.#####.#.#.###.#.#
#.....#.#......#...#.#.#.....#.#.........
#.###.#.#######.###.###########.#######.#
#.#.#.#.#.#...#..........#.#.#...........
###.#.#.#.###.#######.#.###########.#.#.#
#.#.#.#.#.#.#.#.#...#.#.#..#.............
#.#.#.#.#.#.###.#.#.#####.###.#.#######.#
#.#.....................................E
#########################################